NO                    ./textures/42_N.png
SO ./textures/42_S.png
EA ./textures/42_E.png
WE ./textures/42_W.png

C  128,0,128
F  255, 192, 203

111111111111111111111111
100000000000000000000001
101111111111111111111101
101000000000000000000101
101011111111111111110101
101010000000000000010101
101010111111111111010101
101010100000000001010101
101010101111111010101101
101010101000001010101101
101010101011101010101101
101010101010001010101101
101010101010001010101101
101010101101011010101101
101010101010001010101101
101010101011011010101101
10101010010N001010101101
101010100001010101010101
100000011000101010101101
100001000010101010101101
101100000001010101010101
100000001000000000010001
111111111111111111111111
