NO ./assets/textures/surfaces/bricks_dark.png
SO ./assets/textures/surfaces/bricks_dark.png
WE ./assets/textures/surfaces/bricks_dark.png
EA ./assets/textures/surfaces/bricks_dark.png

F 20,20,20
C 100,100,250

11111111111111111111111
11000000000000000111111
11000000000000000111111
11000001111100000111111
1e0000000000000001mmm11
1e000000000000000D0S1111
1e0000000000000001000111
110000011111000001000111
11000000000000000111111
11111111111111111111111
