NO ./textures/42_N.png
SO ./textures/42_S.png
EA ./textures/42_E.png
WE ./textures/42_W.png

F 220,100,0
C 225,30,0

        11111111111111111111111
        10000000001100000000001
        1011000001110000000N001
        10010000000000000000001
1111111110110000011100000000001
100000000011000001110000000000011
111101111111110111000000100000001
111101111111110111010100100000001
110000001101010111000000100000001
100000000000000011000000100000001
100000000000000011010100100000001
110000011101010111110111100011111
11111111 1110101 101111010001
1111 111 1111111 111111111111
