NO ./textures/42_N.png
SO ./textures/42_S.png
EA ./textures/42_E.png
WE ./textures/42_W.png

F  220, 100, 0
C  225, 30, 0

        1111111111111111111111111
        1000000000110000000000001
        1000000001110000000000001
        10010000000000000000N0001
111111111011000001110000000000001
10000000001100000111011111111111
11110111111111011100000010001
11110111111111011101010010001
10000000110101011100000010001
10000000000000001100000010001
10000000000000001101010010001
1100000111010101111101111000111
11111111 1110101 101111010001
1111 111 1111111 111111111111
