NO ./textures/42_N.png
SO ./textures/42_S.png
EA ./textures/42_E.png
WE ./textures/42_W.png

C 128,0,128
F 255,192,203

111111
100001
l00001
100N01
111111
